WWWWWWWWWWWWWWWWWWWWWWWWWWWWWWWWWWWWWWWWWWWWW
W      W                                    W
W      W                                    W
W      W                                    W
W      W                                    W
W      WWWWWWWW                             W
W             W                             W
W             W                             W
W             W                             W
W      W      W                             W
W      W      W                             W
W      W      W                             W
W      W      W                             W
W      W      WWWWW                         W
W      W                                    W
W      W                                    W
W      WWWWWWWWWWWWWWWW                     W
W                                           W
W                                           W
WWWWWWWWWWWWWWWWWWWWWWWWW                   W
W                       W                   W
W                                           W
W                                           W
W                                           W
W                                           W
W                                           W
W                                           W
W                                           W
W                                           W
W                                           W
W                                           W
W                                           W
W                                           W
W                                           W
W                                           W
W                                           W
W                                           W
W                                           W
W                                           W
W                                           W
W                                           W
WWWWWWWWWWWWWWWWWWWWWWWWWWWWWWWWWWWWWWWWWWWWW