WWWWWWWWWWWWWWWWWWWWWWWWWWWWWWWWWWWWWWWWWWWWWWWWWWWWWWWWWWWWWWWWWWWWWWWWWWWWWWWWWWWWWWWWWWW
W      W                                                                                  W
W      W                                                                                  W
W      W                                                                                  W
W      W                                                                                  W
W      WWWWWWWWW                                                                          W
W              W                                                                          W
W              W                                                                          W
W              W                                                                          W
W      W       W                                                                          W
W      W       W                                                                          W
W      W       W                                                                          W
W      W       W                                                                          W
W      W       WWWWW                                                                      W
W      W                                                                                  W
W      W                                                                                  W
W      WWWWWWWWWWWWWWWWWWWWWWWWW                                                          W
W                                                                                         W
W                                                                                         W
WWWWWWWWWWWWWWWWWWWWWWWWWWWWWWWWWWW                                                       W
W                                 W                                                       W
W                                                                                         W
W                                                                                         W
W                                                                                         W
W                                                                                         W
W                                                                                         W
W                                                                                         W
W                                                                                         W
W                                                                                         W
W                                                                                         W
W                                                                                         W
W                                                                                         W
W                                                                                         W
W                                                                                         W
W                                                                                         W
W                                                                                         W
W                                                                                         W
W                                                                                         W
W                                                                                         W
W                                                                                         W
W                                                                                         W
WWWWWWWWWWWWWWWWWWWWWWWWWWWWWWWWWWWWWWWWWWWWWWWWWWWWWWWWWWWWWWWWWWWWWWWWWWWWWWWWWWWWWWWWWWW